
F 71,24,1
C 62,64,71


NO textures/xpm/abadie/abadie_N.xpm
WE textures/xpm/abadie/abadie_W.xpm
SO textures/xpm/abadie/abadie_S.xpm
EA textures/xpm/abadie/abadie_E.xpm


1111111111111111111111111111
1000011111100001000010000001
10W00101000000000000000000011
100000200110000100001000000011
111111110111111111111111111101
100000010000000000000000000111
1000000100111111111111111111
1000000100100000001000000001
1000000100100000001000000001
1110011100100000001000000001
1000000000000000001000000001
1211111111111111111111221111
1000000000000000000000000001
1111111111111111111111111111