
F 71,24,1
C 62,64,71


NO textures/xpm/abadie/abadie_N.xpm
WE textures/xpm/abadie/abadie_W.xpm
SO textures/xpm/abadie/abadie_S.xpm
EA textures/xpm/abadie/abadie_E.xpm


111111111111111111111111111111111111111111111111111111111
1000011111100001000010000001                            1
1000000000000001000010000001                            1
1000011101100001000010000001                            1
1111111101111101111111110111                            1
1000000100000000000000000001                            1
1000000100111121111111111111                            1
1000000100100000001000000001                            1
10000001001000N00010000000001                           1
1110011100100000001000000001                            1
1000000000000000001000000001                            1
1011111111111111111111001111                            1
1000000000000000000000000001                            1
111111111111111111111111111111111111111111111111111111111