F 70,70,70
C 180,180,180


NO textures/xpm/castle/castle_N.xpm
SO textures/xpm/castle/castle_S.xpm
WE textures/xpm/castle/castle_W.xpm
EA textures/xpm/castle/castle_E.xpm


1111111     1111111             1111111111111111
1000001     1000001             1000000000000001
1000001     1000001             1011111111000001
1000001     1000001            1001      1000001
1000001     1000001           1001       1111111
1110111111111110111           101
 1100000000000001      1111111101
 1111111001111111      1000000001
       1001            1011111101
       1001111111111111101    101111111111
       1000000000000000001    100000000001
       1001111111111111111    111111000001
       1001                        1000001
       1001111111111111            1000001
       10000000000000W1            1111111
       1111111111111111