NO textures/xpm/tunnels/tunnels_N.xpm
SO textures/xpm/tunnels/tunnels_S.xpm
WE textures/xpm/tunnels/tunnels_W.xpm
EA textures/xpm/tunnels/tunnels_E.xpm

F 70,70,70
C 180,180,180

 1 111111111111111          111 1111
1S10000000000000001        1000100001
1010000000111111101111     100010111
10100000000000001000001    1000000001
10111111111000001010001    1011111101
10100000001000001010001    1010000001
1011111011100000101111111111010000001
1010000000000000100000000000010000001
101000111111111011111111011111010111
101000100000001000000001000000010101
101000100000001000000001000000010101
101000100000001000000001000000010101
101000100000001000000001000000010001
10100000000000100000000100000001111
101111111111111000000001000000000001
101000000000101000000001000000010001
101011111110101111111101011111110001
1000001 1000100000000001000000010101
1000001 1011111000000001000000000101
1000001 1010001000000001000000010101
100000111010001000000001000000000101
100000100010001000000001000000010101
 11011101110001000000001000000010101
  1010000010000000000000000000010101
111010000010001111111111111111010101
100010000010001000000000000001010101
101111110111011011111101000001011101
10000000010001000000000100000111 101
100000000100010000000001000001   101
100000000100000000000001000001   101
101111111111111111111111111111111101
100000000000000000000000000000000001
 1111111111111111111111111111111111